############
#S_________#
##_#__######
#__________#
#__#__####_#
#__#_____#_#
####__####_#
#_____#____#
#######_##_#
#E_______#_#
############
