#################
#S_#________#___#
#__#__####__#___#
#_____#_________#
#__#__#__####___#
#__#__#__#__###_#
#__#######__#___#
#__#__________###
#__#__#######___#
#__#_____#__###_#
####__####__#####
#_______________#
#__####__####___#
#_____#__#______#
#############___#
#E______________#
#################
