#######
#_____#
#__#__#
#S_#E_#
#######
