#####################
#_S_#___#___#___#___#
#_#_#_#_#_#_#_#_#_#_#
#___#_#_#_#_#_#_#_#_#
#_#___#___#___#___#E#
#####################
