######
#S___#
#____#
#___E#
######
