##############
#____________#
#____##__###_#
#__#_#S#__##_#
#__#____#__#E#
##############
